R 500 250
NO ./eval/texture/wall5.xpm
SO ./eval/texture/wall6.xpm
WE ./eval/texture/wall3.xpm
EA ./eval/texture/wall2.xpm
S ./eval/texture/flower.xpm


F 0  ,255     ,      0          
C 0,0,255

        111111111111
        1000000000001
        1002000020001
        1000000000001
111111112000200000201
100000000000000020001
100000002000002002001
100020000000000000001
100000000002000000001
11111110000000002000111111111
      10000000000000000100001
      10000020000000000120001
      10000000011111100100001
      1020000001    100000201
      1000000001    1000W0001
      10000000011111100000201
      10000000000000000020001
      12000000000000020000001
      11111111111111111111111
